11111111111
1P00C000011
10110000101
1E100001001
11111111111
