11111111111
1000000P011
10110010101
1E110001111
11111111111
