11111111111
1P000000011
10110000101
1E1C1001001
11111111111
