1111111111111111111111111111111111111111111111111111111111111111111111111111111
1111101111111111111111111111111111111111111111111111111111111111111111111111111
1111111111111E11111111111111111111111111111111111111111111111111111111111111111
111111111111111111111111111111P111111111111111111111111111111111111111111111111
11111111C1111111111111111111111111111111111111111111111111111111111111111111111
1111111111111111111111111111111111111111111111111111111111111111111111111111111
